GATGTACATG	ATAGAAACGA
TTCAGATTCT	TCCGTGCAAG
CGTACTACGC	AATGGGACAC
GCTATTATAG	TATTAGGCGA
CAGAAGGAAC	CAATCATCAC
AGACTTTTAA	CAGTTTTACT
GGCAACTGTG	CTTTCTAGAT
AAATTCGCGG	TGTGATACCT
CTTAGACACT	TGTTAACAAC
AGCGGACTAT	TTGCTTTCAG
GAGACGCTAC	CAGGAACTAA
GTCATCGTGC	TCGGGCGGAT
TCATTAACAG	ACGTATAGTG
GCTTCGCTTA	TACTTAAGGC
CTGGCAAAGA	CATGCGGGTG
TCGCTTGAAG	TCGCACTCCG
ATGAACTTTG	GAAACTGAAA
CAGAGATACG	TACAGGCGCA
GGCTGATAAA	GTTGGCATTT
TATTTGTCGC	GTTTTAGGAA
TTAAGGCAAA	AGATTGGCGG
ACAGTATTAT	GAGCGGGTTT
TGGATGCTAT	CGGGAAAGGG
TCGAATTTCG	TTCTTAGGCG
TACTATGGCG	AACACAATAA
TAGCTTAGTG	TTCCGGCGAG
GTCAGGCATG	TTTGTTTTAT
GGTTGGTGGT	GCAGGTGCAG
ACATGTAGCT	ATAAGGACCT
GCGAACAATG	TCAGTTATCC
TGTTGCTTGC	AATGGAATGT
TAACAGCAAT	TGTAATTGAT
GTTTGGACTC	TCAGTGGGTT
CATTATGCTA	GTGGACGTTG
GAGTAAGTGA	CTCCTGCAAA
GAGCGGTGTA	TTCGGATTCC
CGTAAGTCGA	AATCGGGTCA
TGGCACGTTT	AGTCGCCGAC
GAAATCTTTT	CATAAGAAGT
AACAACGCAA	AGGCAGGAAA
ATGTTGTGGC	CTTATCCTTG
TAACTCATTC	GGTCGAAGGG
TCGACTATAT	CAAGAGGTGA
TATCAGTCTG	CTACTGGTGG
CTATATGTAG	TATGTTCATC
TGCAATACGG	AGGCTTGTTC
AAACTGGTGT	TCGACAGCAG
AATTAGGCGT	GTAAATGGGA
ACTGTTCAGG	CGGTAATACG
CAGTATTGTT	CATTAGTAAA
GTACTATAGT	TTAAAGGTTC
ACAGACATTT	TAGAAATGGT
GTCTTTGGAT	CAACAATGGG
CTTGATCTAT	AAATATCGAA
GTATGTCAGG	GCCTGGTAGT
TATTCAACTG	AAAGACTCTT
TTTTGACGGA	TTAACACTTA
ATGGTAGAAA	GTTAAGGCTA
GTGCTCTATC	GTCACAGGTT
GTTATAGTTG	TTTGAAAGTG
AGGATCTTAC	GATTGGGTGC
TGCATTTGAA	TAAAGGATGT
AATTCGGATA	TATTCAATAT
GGTTGAGAGC	GATGATCGAC
CAAGGCTCAT	TAGTGGAGTC
GAATGGAAGC	GCTAAACTTC
CTTCTATATG	TTTTGATTAA
TCTGGATTAC	ACTGTTTAGA
TTGATCAGTA	ATGAGTGATA
ATTTTTGTCG	CTATACCTCC
TACGACTGAA	TCTTGGCTCA
AAAGTTGCAA	CGACAGAATG
GGCGTGCTTT	CCTCCTGGAG
CGGCGGATTT	AGCATTTTCT
CGACAAAGTG	TACTAAGTAG
TGCGTAATTC	AGTTTAAGGA
CAAATGTCGT	AAACTGGCCT
CAGCTAGCTT	ATAGGTAGGG
ACACGGCTCT	TATCAGGGTC
ATTATGACTG	GAATGCGCAA
ACGCATAGAC	CACGGGTCAA
TGGAAGGACT	ATGGGTCGCC
TAAGTAGATA	CGGATACAAA
CACAAGTATA	TCGCCGGTTA
TAAGAATGCG	TAAATGTAAA
ATATGTGTGA	GCAGTGGAAA
ACACAGTGTG	CGAGTAGTCT
AGCACTGTAT	ATTTCTTCAA
ACTATGCGAG	TGTTTGATCC
CTACATGCTC	CGGGTCTATC
CTTCTGGTGG	CTGCGGGATG
GGATGCTCGA	GCGGTGCTCT
CAGCGAAGGA	GTAACGCAGA
GTAAAGACGT	TGATACAAAT
TTGCTACAAC	CCTAGGTCAC
TGGAAACGGT	TCTTTAGCGG
GGTTACATAA	TGCAGTCTTA
CAGCATCATG	TAAATACCTT
TCGGAAACTG	GGTAACGGAC
AAATAGAGAC	GCGAGGAATG
CTGTAACTTT	TCATGGAACT
TTCGAGTCGA	TTGCTTATCT
GTGGCTCATG	CTCATTGGCA
TGAAATGGTC	GTCTCGGTTG
ATTTTTAGTC	GCAACGGTCG
CGAATTTCAG	CTTTGTGCGA
CTGCAGTGGA	CGGACAGTCC
TCATTTGTTT	GTGGGCAGAG
TTGCAACTGG	CCTAGGATGG
AATGCAATGT	TTTAGGTCTT
AGATGGCTGG	TGGAATGTGA
GTCGCAGTAA	CGTCTAGCCG
GAATTCGGAA	GGAACTTTGA
AGGCATGAGT	TGTGGACACA
GGTTCAAGAG	TACTGGCATT
TGTATGAATT	AAATGAAATT
CGCATACTGC	AGTCGGAACG
CTTCGTGTCA	CGAAGGCAAT
ATATTAGCAC	CTTACATAAA
TGACGTATAT	GGGCATATCA
TGGAACATCA	CACTCTAGGG
ACATGGTCAT	ATCAGGTCAG
CTAGTAGTTC	GCGTACAACT
CGCGAAATAG	GCAATCTGGG
GTGCTAAGCG	AGGGTCGGCA
TAGAGATCAT	CACTAGGCTG
GTTGAACTCG	GAGCGTGGGA
GATTTACGAC	TGGACAAACA
TTTAGAATGG	ATGTAGGTCC
GGTTAGGTTG	GCTTCAACTA
AGCATCGACA	TCGGATTGGG
TTGATATCGC	TAGGTTGGCG
ACACGTAAGG	GTGTCGGACT
TTTAATGCGA	CTAGGGATCC
CTATCAAGCG	ATTGAGGACA
CGATAGAAGA	GAATTTTGGC
ACATATCGGA	CTATCTGTCG
GTGGAATAAC	TACTAGGGCT
GAGTGTACAA	ACTGAAAGAC
GTTTACGGCG	GAGCAGAGCT
TATGCTTTTG	CCTTGTAGTA
ATGAGGACGA	CTAGCAGGGC
CGATAATTGT	CACTTTTCTC
AAGTTTGAAC	CATAATCACG